{
    "lv0":
        {
            "ascii": [
                "--G-------",
                "-----G----",
                "---G------",
                "----------",
                "-----P----",
                "---------N",
                "----------",
                "---Y------",
                "----Z-G---",
                "----------"
            ]
        },
    "lv1":
        {
            "ascii": [
                "----------",
                "---G-GF---",
                "-----GM---",
                "----------",
                "-------GO-",
                "P------G--",
                "----------",
                "--G-------",
                "---------N",
                "----------"
            ]
        },
    "lv2":
        {
            "ascii": [
                "------G---",
                "----------",
                "--G-------",
                "--GIGF---N",
                "----------",
                "-----E----",
                "-----G----",
                "----------",
                "P-----GY--",
                "----------"
            ]
        },
    "lv3":
        {
            "ascii": [
                "---G------",
                "----GF----",
                "----------",
                "P---GC----",
                "------U---",
                "----------",
                "---------N",
                "---GB-----",
                "-----GF--G",
                "----------"
            ]
        },
    "lv4":
        {
            "ascii": [
                "----------",
                "-G-O------",
                "-GW----G--",
                "----------",
                "------AR--",
                "--------GY",
                "p---------",
                "------G---",
                "----------",
                "----------"
            ]
        }
}